\bdona\s+remedios\s+trinidad\b	drt
\bjose\s+paciano\s+laurel\b	jp laurel
\bjose\s+protasio\s+rizal\b	j rizal
\bmanuel\s+luis\s+quezon\b	ml quezon
\bdona\s+julia\s+vargas\b	julia vergas
\bmanuel\s+l\s+quezon\b	ml quezon
\bmanuel\s+quezon\b	ml quezon
\bjose\s+p\s+rizal\b	j rizal
\bphilippines\b	p
\bj\s+p\s+laurel\b	jp laurel
\bm\s+l\s+quezon\b	ml quezon
\bmac\s+arthur\b	mcarthur
\bboulevard\b	blvd
\bextension\b	ext
\bj\s+p\s+rizal\b	j rizal
\bkilometer\b	km
\bmacarthur\b	mcarthur
\bmc\s+arthur\b	mcarthur
\bpresident\b	pres
\bbarangay\b	
\bgovernor\b	gov
\bjp\s+rizal\b	j rizal
\bcaptain\b	cap
\bgeneral\b	gen
\bhighway\b	hwy
\bpackage\b	pkg
\bavenue\b	av
\bdoctor\b	dr
\bhi\s+way\b	hwy
\bnumber\b	#
\bstreet\b	st
\bblock\b	b
\bd\s+r\s+t\b	drt
\bdrive\b	dr
\bhiway\b	hwy
\bnorth\b	n
\bphase\b	p
\bsouth\b	s
\bblck\b	b
\bblok\b	b
\bbrgy\b	
\beast\b	e
\bextn\b	ext
\broad\b	rd
\bunit\b	u
\bwest\b	w
\bave\b	av
\bbgy\b	
\bblk\b	b
\blot\b	l
\bnum\b	#
\blt\b	l
\bno\b	#
\bph\b	p
