\bclemens\s+maria\s+hofbauer\b	c m hofbauer
\bavtomobilska\s+cesta\s+hc\b	a
\bclement\s+mary\s+hofbauer\b	c m hofbauer
\bfernverkehrsstrasse\b	a
\bschiffsanlegestelle\b	hajoallomas
\bfussgaengerbruecke\b	brv
\bfaehranlegestelle\b	kompkikoto
\bpjesacki\s+prijelaz\b	gehweg
\badalbert\s+stifter\b	ad stifter
\bfahranlegestelle\b	kompkikoto
\bfelhajto\s+on\s+ramp\b	izh
\bfussgangerbrucke\b	brv
\bgyorsforgalmi\s+ut\b	s
\blehajto\s+off\s+ramp\b	izh
\bstrassenkreuzung\b	kreuzung
\bfreilandstrasse\b	l
\bfubgangerbrucke\b	brv
\bmost\s+za\s+pjesake\b	brv
\bpanoramastrasse\b	panoramaut
\brazgledna\s+cesta\b	panoramaut
\bturisticka\s+ruta\b	panoramaut
\bverbingungsgang\b	koz
\bfussgaengerweg\b	gehweg
\bpanoramski\s+put\b	panoramaut
\bpjesacka\s+staza\b	gehweg
\bschnellstrasse\b	s
\bsteitenstrasse\b	zufahrt
\btreppenaufgang\b	lepcso
\bturisticki\s+put\b	panoramaut
\bbundesstrasse\b	a
\beuropastrasse\b	e
\bfussgangerweg\b	gehweg
\bkeresztezodes\b	kreuzung
\blandesstrasse\b	l
\bprachtstrasse\b	allee
\bprivatstrasse\b	p
\bseitenstrasse\b	zufahrt
\bslijepa\s+ulica\b	zsakutca
\bavtocesta\s+ac\b	a
\bbuergersteig\b	gehweg
\bfahrtstrasse\b	izh
\bfahrtstrecke\b	kurs
\bkreisverkehr\b	rondo
\blandebruecke\b	molo
\blandungssteg\b	molo
\bnebenstrasse\b	zufahrt
\bquertraverse\b	querung
\bautostrasse\b	a
\bburgersteig\b	gehweg
\belkerulo\s+ut\b	zufahrt
\bfahrstrasse\b	ut
\bkammersberg\b	kbg
\bkorforgalom\b	rondo
\blandebrucke\b	molo
\blandstrasse\b	a
\bpristaniste\b	molo
\bslepa\s+ulica\b	zsakutca
\bwohnstrasse\b	lakotelep
\banlegesteg\b	molo
\bdurchfahrt\b	pasaza
\bfahrradweg\b	radweg
\bfahrtroute\b	kurs
\bgradki\s+zid\b	varosfal
\bmestni\s+zid\b	varosfal
\bozka\s+ulica\b	koz
\bprikljucek\b	izh
\bproffessor\b	prof
\braskrsnica\b	kreuzung
\breiseroute\b	kurs
\bsilberwald\b	/sw
\bstadtmauer\b	varosfal
\bstepeniste\b	lepcso
\bwohngebiet\b	lakotelep
\bzaobilazak\b	obvoz
\bautocesta\b	a
\bautopalya\b	a
\bboulevard\b	allee
\bdirecktor\b	dir
\bdurchgang\b	koz
\bfahrtrabe\b	izh
\bferdinand\b	ferd
\bgaesschen\b	koz
\bgyaloghid\b	brv
\bingenieur\b	ing
\bkeresztut\b	kreuzung
\bobvoznica\b	zufahrt
\bperimetar\b	zufahrt
\bprofessor\b	prof
\bpromenade\b	korzo
\braskrizje\b	kreuzung
\bsackgasse\b	zsakutca
\bstopnisce\b	lepcso
\buebergang\b	querung
\bumfahrung\b	zufahrt
\bumleitung\b	obvoz
\bvikendica\b	koca
\bvozni\s+pas\b	pas
\bauffahrt\b	izh
\bausfahrt\b	ausgang
\bautobahn\b	a
\bcestovni\b	zufahrt
\bdirector\b	dir
\bdvorisce\b	hof
\bdvoriste\b	hof
\bfahrbahn\b	pas
\bfahrspur\b	pas
\bgasschen\b	koz
\bgefaelle\b	lejto
\bgehsteig\b	gehweg
\bkrizisce\b	kreuzung
\bkrozisce\b	rondo
\blandhaus\b	koca
\bnabrezje\b	kai
\bobilazak\b	obvoz
\borszagut\b	a
\bprepreka\b	querung
\bterelout\b	obvoz
\bterrasse\b	terasa
\btraverse\b	querung
\btrottoir\b	gehweg
\bubergang\b	querung
\babfahrt\b	izh
\banstieg\b	lejto
\bavenija\b	ut
\bbruecke\b	hid
\bbulevar\b	allee
\bdoktorr\b	dr
\bfussweg\b	gehweg
\bgefalle\b	lejto
\bkastely\b	var
\bkijarat\b	ausgang
\bnyaralo\b	koca
\bpassage\b	pasaza
\bpokriti\b	arkad
\brakpart\b	kai
\bschloss\b	var
\bstrasse\b	ut
\bsugarut\b	ut
\btvrdava\b	var
\butvonal\b	kurs
\bviadukt\b	hid
\bviertel\b	vtl
\bvozisce\b	pas
\babhang\b	lejto
\balagut\b	tunel
\barkada\b	arkad
\barkade\b	arkad
\bbrucke\b	hid
\bdoktor\b	dr
\bdulout\b	dulo
\bdvorac\b	var
\bhaziko\b	koca
\bhuette\b	koca
\bkikoto\b	hafen
\bkorter\b	korond
\bmarina\b	kai
\bnadhod\b	brv
\bnadvoz\b	hid
\bnosioc\b	pas
\bosveny\b	gehweg
\bpespot\b	gehweg
\bpredor\b	tunel
\bprehod\b	pasaza
\bpriklj\b	izh
\bprolaz\b	pasaza
\bsetany\b	korzo
\bterasz\b	terasa
\btreppe\b	lepcso
\btunnel\b	tunel
\buttest\b	pas
\bwiener\b	wr
\bcesta\b	ut
\bfasor\b	allee
\bgasse\b	koz
\bhutte\b	koca
\bizhod\b	izh
\bkorut\b	allee
\bplatz\b	ter
\bpomol\b	molo
\brampa\b	izh
\brampe\b	izh
\broute\b	kurs
\bstaza\b	koz
\bsteza\b	koz
\budvar\b	hof
\bulica\b	ut
\bumweg\b	obvoz
\bburg\b	var
\bgang\b	koz
\bluka\b	kai
\bmost\b	hid
\bnord\b	n
\bputa\b	pas
\bquai\b	kai
\bruta\b	kurs
\butca\b	ut
\bwest\b	w
\bdes\b	d
\bost\b	e
\bstr\b	ut
\bsud\b	s
\btrg\b	ter
\bvon\b	v
\bam\b	a
\bb\b	a
\bo\b	e
