\bappenzell\s+rhodes\s+exterieures\b	ar
\bfaubourg\s+philippe\s+suchard\b	fbg ph suchard
\bappenzell\s+ausserrhoden\b	ar
\bappenzell\s+innerrhoden\b	ai
\bjacques\s+rene\s+fiechter\b	jacq rene fiechter
\bfaubourg\s+ph\s+suchard\b	fbg ph suchard
\bjura\s+north\s+vaudois\b	jura nord vaudois
\bprettigovia\s+davos\b	davos
\bbasel\s+landschaft\b	bl
\bprattigau\s+davos\b	davos
\bsankt\s+silvester\b	st silvester
\bbale\s+campagne\b	bl
\bbasilea\s+citta\b	bs
\bsankt\s+stephan\b	st stephan
\bwallis\s+valais\b	vs
\bintersection\b	crocevia
\bintersezione\b	crocevia
\bsaint\s+gallen\b	sg
\bsankt\s+gallen\b	sg
\bschaffhausen\b	sh
\bbasel\s+stadt\b	bs
\bbelinzonese\b	bellinzona
\bsaint\s+gallo\b	sg
\bsan\s+nazzaro\b	s nazzaro
\bsan\s+vittore\b	s vittore
\bsankt\s+gallo\b	sg
\bschaffhouse\b	sh
\bswitzerland\b	ch
\bwinterthour\b	winterthur
\bbale\s+ville\b	bs
\bbasel\s+city\b	bs
\bbasel\s+land\b	bl
\bbasel\s+stad\b	bs
\bbazel\s+stad\b	bs
\bbellinzone\b	bellinzona
\bcroisement\b	crocevia
\bdeviazione\b	umweg
\benclave\s+de\b	
\bgraubunden\b	gr
\bsaint\s+gall\b	sg
\bsan\s+gallen\b	sg
\bsankt\s+gall\b	sg
\bst\.\s+gallen\b	sg
\bvaud\s+waadt\b	vd
\bwaadt\s+vaud\b	vd
\bcarrefour\b	crocevia
\blaufental\b	laufen
\bneuchatel\b	ne
\bneuenburg\b	ne
\bnidwalden\b	nw
\brotatoria\b	rotonda
\bsan\s+gallo\b	sg
\bsciaffusa\b	sh
\bsolothurn\b	so
\bst\s+gallen\b	sg
\bst\.\s+gallo\b	sg
\bthurgovia\b	tg
\bthurgovie\b	tg
\bumleitung\b	umweg
\bauffahrt\b	rampa
\bausfahrt\b	rampa
\bavvocato\b	avv
\bbanchina\b	kai
\bd\\'uster\b	uster
\bfreiburg\b	fr
\bfribourg\b	fr
\bfriburgo\b	fr
\bgessenay\b	saanen
\bgrigioni\b	gr
\bincrocio\b	crocevia
\bkreuzung\b	crocevia
\bmaloggia\b	maloja
\bnidvaldo\b	nw
\bobwalden\b	ow
\bsan\s+gall\b	sg
\bst\s+gallo\b	sg
\bst\.\s+gall\b	sg
\bterrazza\b	terrasse
\bturgovia\b	tg
\bzofingue\b	zofingen
\babfahrt\b	rampa
\bargovia\b	ag
\bargovie\b	ag
\bdocteur\b	dr
\bfriburg\b	fr
\bginevra\b	ge
\bglarona\b	gl
\bgrisons\b	gr
\blucerna\b	lu
\blucerne\b	lu
\bnidwald\b	nw
\bobvaldo\b	ow
\bschweiz\b	ch
\bschwytz\b	sz
\bsoletta\b	so
\bsoleure\b	so
\bst\s+gall\b	sg
\bstrasse\b	ch
\bthurgau\b	tg
\bturicum\b	zh
\bvallais\b	vs
\bvallese\b	vs
\bzuerich\b	zh
\baargau\b	ag
\bbienna\b	biel
\bbienne\b	biel
\bbrigue\b	brig
\bchemin\b	ch
\bdetour\b	umweg
\bdoctor\b	dr
\bgeneva\b	ge
\bgeneve\b	ge
\bglaris\b	gl
\bglarus\b	gl
\blaufon\b	laufen
\bluzern\b	lu
\bobwald\b	ow
\bpiazza\b	place
\bregion\b	
\bruelle\b	gasse
\bsainte\b	
\bschwyz\b	sz
\bsortie\b	rampa
\bstrada\b	via
\bsvitto\b	sz
\btessin\b	ti
\bthoune\b	thun
\bticino\b	ti
\bvalais\b	vs
\bvicolo\b	gasse
\bwallis\b	vs
\bzurich\b	zh
\bzurigo\b	zh
\baaray\b	aarau
\bberna\b	be
\bberne\b	be
\bbriga\b	brig
\bcorso\b	ch
\bcorte\b	clos
\bgiura\b	ju
\bmaria\b	m
\bmount\b	mt
\bnorth\b	n
\bouest\b	o
\bplatz\b	place
\bponte\b	pont
\brampe\b	rampa
\bsaint\b	
\bsant'\b	s
\bsanta\b	s
\bsouth\b	s
\bstadt\b	
\bviale\b	ch
\bviege\b	visp
\bwaadt\b	vd
\bbern\b	be
\bgenf\b	ge
\bieme\b	
\bjura\b	ju
\bnord\b	n
\bquai\b	kai
\bstad\b	
\bsteg\b	pont
\bvaud\b	vd
\bwest\b	o
\bzoug\b	zg
\bzugo\b	zg
\bdes\b	d'
\beme\b	
\bere\b	
\best\b	
\bles\b	l'
\bmte\b	mt
\brue\b	ch
\bste\b	
\bsud\b	s
\buri\b	ur
\bweg\b	ch
\bzug\b	zg
\bde\b	d'
\bdu\b	d'
\ber\b	
\bin\b	en
\bla\b	l'
\ble\b	l'
\bnd\b	
\brd\b	
\bre\b	
\bst\b	
\bth\b	
\be\b	
\bw\b	o
