\bfederal\s+republic\s+of\s+germany\b	de
\bbundesrepublik\s+deutschland\b	de
\bfreie\s+hansestadt\s+bremen\b	hb
\bmecklenburg\s+vorpommern\b	mv
\bnorth\s+rhine\s+westphalia\b	nw
\brhineland\s+palatinate\b	rp
\bnordrhein\s+westfalen\b	nw
\bschleswig\s+holstein\b	sh
\bbaden\s+wurttemberg\b	bw
\bjohann\s+sebastian\b	joh seb
\bregionalverband\b	
\brheinland\s+pfalz\b	rp
\bsachsen\s+anhalt\b	s
\bbundesstrasse\b	b
\beuropastrasse\b	e
\blandesstrasse\b	l
\bniedersachsen\b	ni
\bsaxony\s+anhalt\b	s
\bstaatsstrasse\b	s
\bkreisstrasse\b	k
\blower\s+saxony\b	ni
\bstadtverband\b	
\bbrandenburg\b	bb
\bdeutschland\b	de
\bbundesstr\b	b
\blandesstr\b	l
\blandkreis\b	
\bthuringen\b	th
\bthuringia\b	th
\bautobahn\b	a
\beuropean\b	e
\bsaarland\b	sl
\bbavaria\b	by
\bcologne\b	koln
\bgermany\b	de
\bhamburg\b	hh
\bkolonie\b	kol
\bsachsen\b	sn
\bstrasse\b	str
\bbayern\b	by
\bberlin\b	be
\bbremen\b	hb
\bhessen\b	he
\bsaxony\b	sn
\bsudost\b	se
\ballee\b	all
\bhesse\b	he
\bsankt\b	s
\bstadt\b	
\bnord\b	n
\bwest\b	w
\bnes\b	k
\bost\b	o
\bovp\b	k
\bsud\b	s
\bin\b	k
\bnu\b	k
\bst\b	s
