\bkahdeskymmenesensimmäinen\b	21
\byhdeksäskymmenes\b	90
\betelainen\b	e
\bnortheast\b	koillinen
\bnorthwest\b	kaakko
\bpohjoinen\b	p
\bsoutheast\b	lounas
\bsouthwest\b	luode
\bmetsatie\b	mt
\bfinland\b	fi
\betela\b	e
\blansi\b	l
\bnorth\b	p
\bsouth\b	e
\bsuomi\b	fi
\beast\b	i
\bgata\b	g
\btien\b	tie
\bwest\b	l
\bita\b	i
\bvag\b	v
