\blouis\s+antoine\s+bougainville\b	l a bougainville
\bprovence\s+alpes\s+cote\s+d\s+azur\b	u
\bdivision\s+francaise\s+libre\b	dfl
\barnouville\s+les\s+gonesse\b	arnouville
\blanguedoc\s+roussillon\b	k
\bl\s+a\s+de\s+bougainville\b	l a bougainville
\bnord\s+pas\s+de\s+calais\b	o
\balbert\s+schweitzer\b	schweitzer
\bchampagne\s+ardenne\b	g
\bdivision\s+blindee\b	db
\bgeorges\s+guynemer\b	g guynemer
\bpays\s+de\s+la\s+loire\b	r
\bpoitou\s+charentes\b	t
\bbasse\s+normandie\b	p
\bhaute\s+normandie\b	q
\brobert\s+schumann\b	robert schuman
\bcharles\s+gaulle\b	gaulle
\bdepartementale\b	d
\blower\s+normandy\b	p
\bupper\s+normandy\b	q
\bblaise\s+pascal\b	pascal
\bdepartemental\b	d
\bfranche\s+comte\b	i
\bile\s+de\s+france\b	j
\bmidi\s+pyrenees\b	n
\bcorse\s+du\s+sud\b	2a
\bcouffouleux\b	coufouleux
\bhaute\s+corse\b	2b
\bjean\s+monnet\b	jean monet
\blotissement\b	lot
\brhone\s+alpes\b	v
\bacquitaine\b	b
\benclave\s+de\b	
\beuropeenne\b	e route
\baquitaine\b	b
\bautoroute\b	a
\bboulevard\b	bd
\bbourgogne\b	d
\bnationale\b	n
\bseptembre\b	sept
\ballemont\b	allemond
\bauvergne\b	c
\bbretagne\b	
\bbrittany\b	
\bburgundy\b	d
\bdecembre\b	dec
\bespanade\b	esp
\bflemming\b	fleming
\bla\s+croix\b	lacroix
\blimousin\b	l
\blorraine\b	m
\bnational\b	n
\bnovembre\b	nov
\bpicardie\b	s
\bquartier\b	qua
\bcorsica\b	h
\bfevrier\b	fevr
\bjanvier\b	janv
\bjuillet\b	juil
\boctobre\b	oct
\bpassage\b	pass
\bpicardy\b	s
\balsace\b	a
\bavenue\b	ave
\bcarrer\b	cae
\bcentre\b	f
\bchemin\b	chem
\bfrance\b	fr
\bgrande\b	gd
\bregion\b	
\bsainte\b	
\bcorse\b	h
\bd\s+f\s+l\b	dfl
\bde\s+l'\b	
\bde\s+la\b	
\bet\s+du\b	
\bgrand\b	gd
\bmount\b	mt
\bnorth\b	n
\bouest\b	o
\bparis\b	
\broute\b	rte
\bsaint\b	
\bsouth\b	s
\bvilla\b	vil
\bieme\b	
\bnord\b	n
\bwest\b	o
\bdes\b	
\beme\b	
\bere\b	
\best\b	
\bgde\b	gd
\bles\b	
\bmte\b	mt
\brua\b	rte
\brue\b	rte
\bste\b	
\bsud\b	s
\bsur\b	
\bd'\b	
\bde\b	
\bdu\b	
\ben\b	
\ber\b	
\bgr\b	gd
\bin\b	
\bl'\b	
\bla\b	
\ble\b	
\bnd\b	
\bof\b	
\brd\b	
\bre\b	
\bst\b	
\bth\b	
\be\b	
\bw\b	o
