\bbath\s+and\s+north\s+east\s+somerset\b	gb-bas
\bdungannon\s+and\s+south\s+tyrone\b	gb-dgn
\bcheshire\s+west\s+and\s+chester\b	gb-chw
\bnewry\s+and\s+mourne\s+district\b	gb-nym
\beast\s+riding\s+of\s+yorkshire\b	gb-ery
\bmetropolitan\s+borough\s+of\b	
\bnorth\s+east\s+lincolnshire\b	gb-nel
\bhammersmith\s+and\s+fulham\b	gb-hmf
\bkensington\s+and\s+chelsea\b	gb-kec
\bwindsor\s+and\s+maidenhead\b	gb-wnm
\bblackburn\s+with\s+darwen\b	gb-bbd
\bdumfries\s+and\s+galloway\b	gb-dgy
\bsouth\s+gloucestershire\b	gb-sgc
\bthe\s+vale\s+of\s+glamorgan\b	gb-vgl
\bbarking\s+and\s+dagenham\b	gb-bdg
\bcentral\s+bedfordshire\b	gb-cbf
\bkingston\s+upon\s+thames\b	gb-ktt
\bredcar\s+and\s+cleveland\b	gb-rcc
\brhondda,\s+cynon,\s+taff\b	gb-rct
\brichmond\s+upon\s+thames\b	gb-ric
\bthe\s+scottish\s+borders\b	gb-scb
\beast\s+dunbartonshire\b	gb-edu
\bnewcastle\s+upon\s+tyne\b	gb-net
\bwest\s+dunbartonshire\b	gb-wdu
\bkingston\s+upon\s+hull\b	gb-khl
\bliverpool\s+district\b	gb-liv
\bnorth\s+lincolnshire\b	gb-nln
\btelford\s+and\s+wrekin\b	gb-tfw
\bbrighton\s+and\s+hove\b	gb-bnh
\bcity\s+of\s+edinburgh\b	gb-edh
\beast\s+renfrewshire\b	gb-erw
\bkirklees\s+district\b	gb-kir
\blondon\s+borough\s+of\b	
\bneath\s+port\s+talbot\b	gb-ntl
\bnorth\s+lanarkshire\b	gb-nlk
\bperth\s+and\s+kinross\b	gb-pkn
\bsouth\s+lanarkshire\b	gb-slk
\bbracknell\s+forest\b	gb-brc
\bclackmannanshire\b	gb-clk
\bisle\s+of\s+anglesey\b	gb-agy
\bnorthamptonshire\b	gb-nth
\bnorthern\s+ireland\b	ni
\bshetland\s+islands\b	gb-zet
\bstockton\-on\-tees\b	gb-stt
\bargyll\s+and\s+bute\b	gb-agb
\bbuckinghamshire\b	gb-bkm
\bcarmarthenshire\b	gb-cmn
\bcity\s+of\s+bristol\b	gb-bst
\bgloucestershire\b	gb-gls
\bnorth\s+yorkshire\b	gb-nyk
\bnottinghamshire\b	gb-ntt
\bsefton\s+district\b	gb-sft
\bsouthend\-on\-sea\b	gb-sos
\bcambridgeshire\b	gb-cam
\bcity\s+of\s+london\b	gb-lnd
\bleeds\s+district\b	gb-lds
\bleicestershire\b	gb-lec
\bmerthyr\s+tydfil\b	gb-mty
\bnorth\s+ayrshire\b	gb-nay
\bnorth\s+somerset\b	gb-nsm
\bnorth\s+tyneside\b	gb-nty
\bnorthumberland\b	gb-nbl
\borkney\s+islands\b	gb-ork
\bsouth\s+ayrshire\b	gb-say
\bsouth\s+tyneside\b	gb-sty
\bstoke\-on\-trent\b	gb-ste
\bwaltham\s+forest\b	gb-wft
\bwest\s+berkshire\b	gb-wbk
\bworcestershire\b	gb-wor
\baberdeen\s+city\b	gb-abe
\baberdeenshire\b	gb-abd
\bblaenau\s+gwent\b	gb-bgw
\bcarrickfergus\b	gb-ckf
\bcheshire\s+east\b	gb-che
\bcounty\s+durham\b	gb-dur
\beast\s+ayrshire\b	gb-eay
\bherefordshire\b	gb-hef
\bhertfordshire\b	gb-hrt
\bisle\s+of\s+wight\b	gb-iow
\bmiddlesbrough\b	gb-mdb
\bmilton\s+keynes\b	gb-mik
\bmonmouthshire\b	gb-mon
\bpembrokeshire\b	gb-pem
\bstaffordshire\b	gb-sts
\btower\s+hamlets\b	gb-twh
\bwolverhampton\b	gb-wlv
\bdenbighshire\b	gb-den
\beast\s+lothian\b	gb-eln
\bfulmodestone\b	fulmodeston
\bglasgow\s+city\b	gb-glg
\blincolnshire\b	gb-lin
\bnewtownabbey\b	gb-nta
\bpeterborough\b	gb-pte
\brenfrewshire\b	gb-rfw
\bwarwickshire\b	gb-war
\bwest\s+lothian\b	gb-wln
\bbournemouth\b	gb-bmh
\bcastlereagh\b	gb-csr
\bdundee\s+city\b	gb-dnd
\bdunnamanagh\b	dunamanagh
\beast\s+sussex\b	gb-esx
\beilean\s+siar\b	gb-els
\bking's\s+stag\b	king stag
\bmagherafelt\b	gb-mft
\bmarlborough\b	malborough
\boxfordshire\b	gb-oxf
\bplantagenet\b	plantaganet
\bsouthampton\b	gb-sth
\bwest\s+sussex\b	gb-wsx
\bwestminster\b	gb-wsm
\bballymoney\b	gb-bly
\bbirmingham\b	gb-bir
\bborough\s+of\b	
\bcaerphilly\b	gb-cay
\bcalderdale\b	gb-cld
\bcarnhywell\b	carnhywel
\bceredigion\b	gb-cgn
\bculnacnock\b	culnacnoc
\bdarlington\b	gb-dal
\bderbyshire\b	gb-dby
\bflintshire\b	gb-fln
\bgroesllwyd\b	groes-lwyd
\bhartlepool\b	gb-hpl
\bhillingdon\b	gb-hil
\binverclyde\b	gb-ivc
\blancashire\b	gb-lan
\bmanchester\b	gb-man
\bmidlothian\b	gb-mln
\bnorth\s+down\b	gb-ndn
\bnottingham\b	gb-ngm
\bportsmouth\b	gb-por
\bshropshire\b	gb-shr
\bst\.\s+helens\b	gb-shn
\bsunderland\b	gb-snd
\bwandsworth\b	gb-wnd
\bwarrington\b	gb-wrt
\bballymena\b	gb-bla
\bbanbridge\b	gb-bnb
\bblackpool\b	gb-bpl
\bboulevard\b	blvd
\bcoleraine\b	gb-clr
\bcookstown\b	gb-ckt
\bcraigavon\b	gb-cgv
\bdoncaster\b	gb-dnc
\bfermanagh\b	gb-fer
\bgateshead\b	gb-gat
\bgreenwich\b	gb-gre
\bhampshire\b	gb-ham
\bislington\b	gb-isl
\bleicester\b	gb-lce
\bn\s+ireland\b	ni
\bredbridge\b	gb-rdb
\brotherham\b	gb-rot
\bsheffield\b	gb-shf
\bsouthwark\b	gb-swk
\bstockport\b	gb-skp
\bwakefield\b	gb-wkf
\bwiltshire\b	gb-wil
\bwokingham\b	gb-wok
\balderney\b	aldernay
\bbarnsley\b	gb-bns
\bbradford\b	gb-brd
\bbridgend\b	gb-bge
\bbroadway\b	bdwy
\bcheshire\b	gb-chs
\bcornwall\b	gb-con
\bcoventry\b	gb-cov
\bcrescent\b	cr
\bdistrict\b	
\bhare\s+law\b	harelaw
\bharingey\b	gb-hry
\bhavering\b	gb-hav
\bhighland\b	gb-hld
\bhounslow\b	gb-hns
\bknowsley\b	gb-kwl
\blewisham\b	gb-lew
\blimavady\b	gb-lmv
\bplymouth\b	gb-ply
\bprincess\b	princes
\brochdale\b	gb-rch
\bsandwell\b	gb-saw
\bscotland\b	gb-sct
\bsolihull\b	gb-sol
\bsomerset\b	gb-som
\bstirling\b	gb-stg
\bstrabane\b	gb-stb
\btameside\b	gb-tam
\bthurrock\b	gb-thr
\btrafford\b	gb-trf
\babbotts\b	abbots
\bbedford\b	gb-bdf
\bbelfast\b	gb-bfs
\bbritain\b	gb
\bbromley\b	gb-bry
\bcardiff\b	gb-crf
\bcity\s+of\b	
\bcroydon\b	gb-cry
\bcumbria\b	gb-cma
\benfield\b	gb-enf
\bengland\b	eng
\bfalkirk\b	gb-fal
\bgardens\b	gdns
\bgwynedd\b	gb-gwn
\bhackney\b	gb-hck
\bhighway\b	hwy
\bhillary\b	hilary
\bkingdom\b	gb
\blambeth\b	gb-lbh
\blisburn\b	gb-lsb
\bmoseley\b	mosley
\bnewport\b	gb-nwp
\bnorfolk\b	gb-nfk
\bparkway\b	pkwy
\breading\b	gb-rdg
\brutland\b	gb-rut
\bsalford\b	gb-slf
\bsuffolk\b	gb-sfk
\bswansea\b	gb-swa
\bswindon\b	gb-swd
\bterrace\b	ter
\btorfaen\b	gb-tof
\bwalsall\b	gb-wll
\bwrexham\b	gb-wrx
\bashley\b	ashlea
\bavenue\b	ave
\bbrooke\b	brook
\bcircus\b	cir
\bcliffe\b	cliff
\bcommon\b	comm
\bgarden\b	gdn
\bgb\-ans\b	angus
\bgb\-ant\b	antrim
\bgb\-ard\b	ards
\bgb\-arm\b	armagh
\bgb\-ben\b	brent
\bgb\-bex\b	bexley
\bgb\-bne\b	barnet
\bgb\-bol\b	bolton
\bgb\-bur\b	bury
\bgb\-cmd\b	camden
\bgb\-cwy\b	conwy
\bgb\-der\b	derby
\bgb\-dev\b	devon
\bgb\-dor\b	dorset
\bgb\-dow\b	down
\bgb\-dry\b	derry
\bgb\-dud\b	dudley
\bgb\-eal\b	ealing
\bgb\-eng\b	eng
\bgb\-ess\b	essex
\bgb\-fif\b	fife
\bgb\-ken\b	kent
\bgb\-lrn\b	larne
\bgb\-lut\b	luton
\bgb\-mry\b	moray
\bgb\-myl\b	moyle
\bgb\-nir\b	ni
\bgb\-omh\b	omagh
\bgb\-pol\b	poole
\bgb\-pow\b	powys
\bgb\-wgn\b	wigan
\bgb\-wls\b	wales
\bgb\-yor\b	york
\bhalton\b	gb-hal
\bharrow\b	gb-hrw
\bmedway\b	gb-mdw
\bmerton\b	gb-mrt
\bnewham\b	gb-nwm
\boldham\b	gb-old
\bparade\b	pde
\bslough\b	gb-slg
\bsquare\b	sq
\bstreet\b	st
\bsurrey\b	gb-sry
\bsutton\b	gb-stn
\bthorne\b	thorn
\btorbay\b	gb-tob
\bvalley\b	val
\bwirral\b	gb-wrl
\bclose\b	cl
\bcourt\b	ct
\bdrive\b	dr
\bgreen\b	gn
\bgrove\b	gr
\bhills\b	hill
\bmount\b	mt
\bnorth\b	n
\bplace\b	pl
\bpoint\b	pt
\bridge\b	rdg
\bsaint\b	st
\bsouth\b	s
\bcres\b	cr
\beast\b	e
\blane\b	ln
\bmews\b	mew
\bpark\b	pk
\bridg\b	rdg
\broad\b	rd
\bwest\b	w
\byard\b	yd
\bg\s+b\b	gb
\bn\s+i\b	ni
\bnth\b	n
\bsth\b	s
\bu\s+k\b	gb
\bway\b	wy
\buk\b	gb
