\bboulevard\b	blvd
\bhong\s+kong\b	hk
\bcrescent\b	cres
\bdistrict\b	
\bhongkong\b	hk
\bjunction\b	jct
\bcentral\b	c
\bhighway\b	hwy
\bparkway\b	pkwy
\bavenue\b	ave
\bbypass\b	pass
\bcentre\b	center
\bcommon\b	comm
\bparade\b	pde
\bstreet\b	st
\bcourt\b	ct
\bdrive\b	dr
\bmount\b	mt
\bnorth\b	n
\bplace\b	pl
\bpoint\b	pt
\bsaint\b	st
\bsouth\b	s
\beast\b	e
\blane\b	ln
\broad\b	rd
\bwest\b	w
\bh\s+k\b	hk
\bnth\b	n
\bsth\b	s
