\bspecial\s+region\s+of\s+yogyakarta\b	yo
\bnanggroe\s+aceh\s+darussalam\b	ac
\bbangka\s+belitung\s+islands\b	bb
\bnaggroe\s+aceh\s+darussalam\b	ac
\bspecial\s+region\s+of\s+papua\b	pa
\bspecial\s+region\s+of\s+aceh\b	ac
\bcentral\s+kalimantan\b	kt
\bsoutheast\s+sulawesi\b	sg
\bcentral\s+sulawesi\b	st
\bkh\s+hasyim\s+ashari\b	kh
\bbangka\s+belitung\b	bb
\bjakarta\s+pusat\b	jk
\bjakarta\s+utara\b	jk
\bcentral\s+java\b	jt
\briau\s+islands\b	kr
\bdki\s+jakarta\b	jk
\bjawa\s+tengah\b	jt
\bjalan\s+raya\b	jl raya
\byogyakarta\b	yo
\bgorontalo\b	go
\bindonesia\b	id
\bjalan\s+tol\b	jl tol
\bkyai\s+haji\b	kh
\bbengkulu\b	be
\bnational\b	nasional
\bjakarta\b	jk
\blampung\b	la
\bselatan\b	s
\bbanten\b	bt
\blorong\b	lrg
\bmaluku\b	ma
\bmesjid\b	masjid
\bnumber\b	#
\bbarat\b	w
\bblock\b	blk
\bblok\.\b	blk
\bjalan\b	jl
\bjambi\b	ja
\blebar\b	lbr
\bnorth\b	n
\bpapua\b	pa
\bsouth\b	s
\btimur\b	e
\butara\b	n
\baceh\b	ac
\bbali\b	ba
\bblk\.\b	blk
\bblok\b	blk
\beast\b	e
\bgang\b	gg
\briau\b	ri
\broad\b	rd
\bwest\b	w
\bjln\b	jl
\bno\.\b	#
\bnum\b	#
\bno\b	#
