\bboithre\s+reigiunacha\b	r
\bdroichead\s+coisithe\b	footbridge
\bballa\s+an\s+cathrach\b	city wall
\bboithre\s+naisiunta\b	n
\bboithre\s+aitiula\b	l
\ban\s+tsraid\s+mhor\b	main street
\bperimeter\s+road\b	bypass
\bbealach\s+thios\b	way below
\bbealach\s+thuas\b	way above
\bcursa\s+timpill\b	detour
\bmotarbhealach\b	m
\bnational\s+road\b	n
\bregional\s+road\b	r
\bsli\s+sciamhach\b	scenic route
\bbealach\s+sios\b	way down
\bbealach\s+suas\b	way up
\bcarrbhealach\b	carriageway
\bintersection\b	crosaire
\bseachbhothar\b	bypass
\bbealai\s+euro\b	e
\bcuarbhothar\b	ring road
\bcul\s+de\s+sac\b	dead end
\beuro\s+route\b	e
\blocal\s+road\b	l
\btimpeallan\b	roundabout
\bcrossroad\b	crosaire
\bdroichead\b	bridge
\broscommon\b	rn
\btipperary\b	ta
\bwaterford\b	wd
\bwestmeath\b	wh
\bbailtini\b	cottage
\bcaislean\b	castle
\bcrossing\b	crosaire
\bfootpath\b	cosan
\bkilkenny\b	kk
\blamairne\b	jetty
\blimerick\b	lk
\blongford\b	ld
\bmonaghan\b	mn
\bmotorway\b	m
\bpasaiste\b	passage
\bstairway\b	staighre
\btraverse\b	tras
\bascaill\b	ave
\bbealach\b	wy
\bby\s+road\b	bypass
\bcearnog\b	square
\bciorcal\b	circle
\bdemesne\b	dimein
\bdonegal\b	dl
\bhighway\b	n
\bireland\b	ie
\bkildare\b	ke
\bleitrim\b	lm
\bterrace\b	tce
\bthuaidh\b	n
\btiomain\b	dr
\bwexford\b	wx
\bwicklow\b	ww
\bavenue\b	ave
\bbothar\b	rd
\bcarlow\b	cw
\bcenter\b	lar
\bcounty\b	ck
\bdublin\b	d
\bgalway\b	g
\blaoise\b	ls
\boffaly\b	oy
\bstreet\b	st
\btunnel\b	tollan
\balley\b	ln
\bardan\b	tce
\bcavan\b	cn
\bclare\b	ce
\bclose\b	yd
\bcourt\b	ct
\bcuirt\b	ct
\bdrive\b	dr
\bfield\b	gort
\bgreen\b	glas
\bgrove\b	gr
\bkerry\b	ky
\blaois\b	ls
\blouth\b	lh
\bmeath\b	mh
\bnorth\b	n
\bpairc\b	park
\bplace\b	pl
\brampa\b	ramp
\broute\b	wy
\bsaint\b	st
\bsligo\b	so
\bsouth\b	s
\bsraid\b	st
\btheas\b	s
\bwoods\b	coill
\bclos\b	yd
\bcntr\b	lar
\bcork\b	ck
\beast\b	e
\blana\b	ln
\blane\b	ln
\bmayo\b	mo
\bpath\b	sli
\bquay\b	ce
\broad\b	rd
\bsiar\b	w
\bsiul\b	wk
\bsoir\b	e
\bwalk\b	wk
\bwest\b	w
\byard\b	yd
\bait\b	pl
\bway\b	wy
\bco\b	ck
\bdn\b	d
\bgy\b	g
\bty\b	ta
