\bchinnaswami\s+subramania\s+bharathi\b	bharatiar
\bnetaji\s+subhash\s+chandra\s+bose\b	netaji subhas
\bnetaji\s+subhas\s+chandra\s+bose\b	netaji subhas
\bsardar\s+vallabhbhai\s+patel\b	sardar patel
\bmoulana\s+abul\s+kalam\s+azad\b	maulana azad
\bsardar\s+vallabhai\s+patel\b	sardar patel
\bsubhash\s+chandra\s+bose\b	netaji subhas
\bkumaraswami\s+kamaraj\b	k kamaraj
\bnational\s+expressway\b	ne
\bsubhas\s+chandra\s+bose\b	netaji subhas
\bsubramania\s+bharati\b	bharatiar
\bswami\s+vivekanandha\b	vivekananda
\bthiruvananthapuram\b	tvpm
\bazimabad\s+kusumpur\b	patna
\bjammu\s+and\s+kashmir\b	j&k
\bswami\s+vivekananda\b	vivekananda
\btiruvananthapuram\b	tvpm
\bjawaharlal\s+nehru\b	j nehru
\bnational\s+highway\b	nh
\bchandigarh\s+city\b	ch
\bjammu\s+\&\s+kashmir\b	j&k
\bvallabhai\s+patel\b	sardar patel
\bmajor\s+district\b	md
\bnetaji\s+subhash\b	netaji subhas
\basian\s+highway\b	ah
\bbharathidasan\b	dasan
\bgovt\s+of\s+india\b	goi
\binternational\b	intl
\bstate\s+highway\b	sh
\bvisakhapatnam\b	vskp
\bchickmagalur\b	chicmagalur
\bchikmagaluru\b	chicmagalur
\bvivekanandha\b	vivekananda
\bbharathiyar\b	bharatiar
\bchikmagalur\b	chicmagalur
\bcross\-roads\b	xrd
\bpataliputra\b	patna
\branga\s+reddy\b	rangareddi
\bchandigarh\b	ch
\bcross\s+road\b	cross rd
\bcross\-road\b	xrd
\bcrossroads\b	xrd
\bgovernment\b	goi
\bpatliputra\b	patna
\buniversity\b	uni
\bvijayawada\b	bza
\bahmedabad\b	ahd
\bbangalore\b	blr
\bbengaluru\b	blr
\bchar\-rast\b	chaurah
\bchaurasta\b	chaurah
\bchourasta\b	chaurah
\bcrossroad\b	xrd
\bhyderabad\b	hyd
\bi\.n\.d\.i\.a\b	in
\bkamarajar\b	k kamaraj
\bkasthurba\b	kasturba
\bmain\s+road\b	main rd
\bvijaywada\b	bza
\bcalcutta\b	kol
\bchourast\b	chaurah
\bchowrast\b	chaurah
\bcrossing\b	xrd
\bcrossrds\b	xrd
\bgandhiji\b	gandhi
\bjunction\b	jn.
\bkolkatta\b	kol
\bvaranasi\b	banaras
\bamdavad\b	ahd
\bbenaras\b	banaras
\bchennai\b	che
\bcollege\b	clg
\bcrossrd\b	xrd
\bgateway\b	gtwy
\bheights\b	hts
\bkeralam\b	kl
\bkolkata\b	kol
\bkolkota\b	kol
\bm\s+a\s+i\s+n\b	main
\bshastri\b	sastri
\bvruttha\b	cir.
\bx\s+roads\b	xrd
\bbombay\b	bom
\bcenter\b	cen
\bcentre\b	cen
\bchowdi\b	chok
\bcircle\b	cir.
\bdoctor\b	dr
\bforest\b	frst
\bgarden\b	gdn
\bgatewy\b	gtwy
\bgatway\b	gtwy
\bheight\b	hts
\bindira\b	indra
\bkavala\b	jn.
\bkerala\b	kl
\bmadras\b	che
\bmumbai\b	bom
\bnumber\b	#
\braasta\b	rasta
\bstreet\b	st
\bx\s+road\b	xrd
\bxroads\b	xrd
\bcentr\b	cen
\bchauk\b	chok
\bchouk\b	chok
\bchowk\b	chok
\bcnter\b	cen
\bdelhi\b	del
\bgalli\b	gali
\bgardn\b	gdn
\bgrden\b	gdn
\bgtway\b	gtwy
\bgulli\b	gali
\bgully\b	gali
\bindia\b	in
\bj\s+\&\s+k\b	j&k
\bmukku\b	jn.
\bnaaka\b	jn.
\bpally\b	palli
\bround\b	cir.
\broute\b	rt
\bshree\b	sri
\bsouth\b	s
\bvizag\b	vskp
\bxroad\b	xrd
\bcent\b	cen
\bcntr\b	cen
\beast\b	e
\bgarh\b	gad
\bgrdn\b	gdn
\bhght\b	hts
\bhgts\b	hts
\bj\s+\&k\b	j&k
\bjct\.\b	jn.
\bjnct\b	jn.
\bpeth\b	pet
\brnd\.\b	cir.
\broad\b	rd
\bshri\b	sri
\bsree\b	sri
\bstr\.\b	st
\buniv\b	uni
\bwest\b	w
\bx\-rd\b	xrd
\bxrds\b	xrd
\bcha\b	ch
\bctr\b	cen
\bdoc\b	dr
\bmum\b	bom
\bno\.\b	#
\bno:\b	#
\bnum\b	#
\brte\b	rt
\bst\.\b	st
\bstr\b	st
\bno\b	#
\bn\b	#
