\bcamillo\s+benso\s+conte\s+cavour\b	cavour
\bcavour\s+conte\s+camillo\s+benso\b	cavour
\bgian\s+domenico\s+romagnosi\b	romagnosi
\bromagnosi\s+gian\s+domenico\b	romagnosi
\bernesto\s+teodoro\s+moneta\b	moneta
\bbarletta\s+andria\s+trani\b	bt
\bbenso\s+camillo\s+cavour\b	cavour
\bcamillo\s+benso\s+cavour\b	cavour
\bcavour\s+camillo\s+benso\b	cavour
\bg\s+domenico\s+romagnosi\b	romagnosi
\bverbano\s+cusio\s+ossola\b	vb
\btrentino\s+alto\s+adige\b	trentino sudtirol
\balessandro\s+manzoni\b	a manzoni
\bcavour\s+conte\s+benso\b	cavour
\bcristoforo\s+colombo\b	c colombo
\bdomenico\s+romagnosi\b	romagnosi
\bgaribaldi\s+giuseppe\b	garibaldi
\bgioacchino\s+rossini\b	g rossini
\bgiuseppe\s+garibaldi\b	garibaldi
\bstrada\s+provinciale\b	sp
\balcide\s+de\s+gasperi\b	gasperi
\bbaracca\s+francesco\b	baracca
\bcarbonia\s+iglesias\b	ci
\bde\s+gasperi\s+alcide\b	gasperi
\bfrancesco\s+baracca\b	baracca
\bgiacomo\s+matteotti\b	g matteotti
\bguglielmo\s+marconi\b	marconi
\bmarconi\s+guglielmo\b	marconi
\bvittorio\s+emanuele\b	v emanuele
\balessandro\s+volta\b	volta
\bgiacomo\s+leopardi\b	g leopardi
\bgiovanni\s+pascoli\b	g pascoli
\bgiuseppe\s+mazzini\b	mazzini
\bmazzini\s+giuseppe\b	mazzini
\bromagnosi\s+gian\s+d\b	romagnosi
\bstrada\s+regionale\b	sr
\bvolta\s+alessandro\b	volta
\bantonio\s+gramsci\b	a gramsci
\bcesare\s+battisti\b	c battisti
\bgalileo\s+galilei\b	g galilei
\bgiacomo\s+puccini\b	puccini
\bgiosue\s+carducci\b	g carducci
\bmedio\s+campidano\b	vs
\bmonza\s+e\s+brianza\b	mb
\bpesaro\s+e\s+urbino\b	pu
\bpietro\s+mascagni\b	p mascagni
\bpuccini\s+giacomo\b	puccini
\breggio\s+calabria\b	rc
\bstrada\s+comunale\b	sc
\bcamillo\s+cavour\b	cavour
\bcavour\s+camillo\b	cavour
\bernesto\s+moneta\b	moneta
\bgiuseppe\s+verdi\b	g verdi
\bstrada\s+statali\b	ss
\bvallee\s+d\s+aoste\b	valle aosta
\bascoli\s+piceno\b	ap
\bcaltanissetta\b	cl
\bg\s+d\s+romagnosi\b	romagnosi
\bmassa\s+carrara\b	ms
\breggio\s+emilia\b	re
\bvalle\s+d\s+aosta\b	valle aosta
\bvibo\s+valentia\b	vv
\benrico\s+fermi\b	fermi
\bfermi\s+enrico\b	fermi
\bforli\s+cesena\b	fc
\bolbia\s+tempio\b	ot
\balessandria\b	
\bg\s+garibaldi\b	garibaldi
\bg\s+romagnosi\b	romagnosi
\bgaribaldi\s+g\b	garibaldi
\bugo\s+foscolo\b	u foscolo
\bcampobasso\b	cb
\bde\s+gasperi\b	gasperi
\breggimento\b	rgt
\bsantissima\b	san
\bsantissimi\b	san
\bsantissimo\b	san
\bagrigento\b	ag
\baldo\s+moro\b	a moro
\bbaracca\s+f\b	baracca
\bbenevento\b	bn
\bcatanzaro\b	cz
\bet\s+moneta\b	moneta
\bf\s+baracca\b	baracca
\bfrosinone\b	fr
\bg\s+marconi\b	marconi
\bg\s+mazzini\b	mazzini
\bg\s+puccini\b	puccini
\bla\s+spezia\b	sp
\bmarconi\s+g\b	marconi
\bmazzini\s+g\b	mazzini
\bogliastra\b	og
\bpordenone\b	pn
\bpromenade\b	lungomare
\bpuccini\s+g\b	puccini
\bavellino\b	av
\bb\s+cavour\b	cavour
\bbrindisi\b	br
\bcagliari\b	ca
\bcavour\s+c\b	cavour
\bfrazione\b	fraction
\bgrosseto\b	gr
\bl\s+aquila\b	aq
\blocality\b	localita
\bmacerata\b	mc
\bmaggiore\b	magg
\boristano\b	or
\bpiacenza\b	pc
\bpiazzale\b	l go
\bprinclpe\b	pr
\bsiracusa\b	sr
\btraversa\b	trav
\bvercelli\b	vc
\bbelluno\b	bl
\bbergamo\b	bg
\bbologna\b	bo
\bbolzano\b	bz
\bbrescia\b	bs
\bcaserta\b	ce
\bcatania\b	ct
\bcosenza\b	cs
\bcremona\b	cr
\bcrotone\b	kr
\bfermi\s+e\b	fermi
\bferrara\b	fe
\bfirenze\b	fi
\bgorizia\b	go
\bimperia\b	im
\binterno\b	int
\bisernia\b	is
\blivorno\b	li
\bmantova\b	mn
\bmessina\b	me
\bpalermo\b	pa
\bperugia\b	pg
\bpescara\b	pe
\bpistoia\b	pt
\bpotenza\b	pz
\bravenna\b	ra
\bsalerno\b	sa
\bsassari\b	ss
\bsondrio\b	so
\btaranto\b	ta
\btrapani\b	tp
\btreviso\b	tv
\btrieste\b	ts
\bvenezia\b	ve
\bvicenza\b	vi
\bviterbo\b	vt
\bvolta\s+a\b	volta
\bancona\b	an
\barezzo\b	ar
\bbiella\b	bi
\bchieti\b	ch
\bfoggia\b	fg
\bgenova\b	ge
\bitalia\b	it
\blatina\b	lt
\bmatera\b	mt
\bmilano\b	mi
\bmodena\b	mo
\bnapoli\b	na
\bnovara\b	no
\bpadova\b	pd
\bpiazza\b	l go
\bragusa\b	rg
\brimini\b	rn
\brovigo\b	ro
\bsavona\b	sv
\bsquare\b	l go
\bstrada\b	road
\bstreet\b	via
\bteramo\b	te
\btorino\b	to
\btrento\b	tn
\bvarese\b	va
\bverona\b	vr
\bvicolo\b	vico
\balley\b	vico
\baosta\b	ao
\baoste\b	ao
\bbozen\b	bz
\bcorso\b	c so
\bcorte\b	l go
\bcuneo\b	cn
\bdagli\b	
\bdalla\b	
\bdalle\b	
\bdallo\b	
\bdegli\b	
\bdella\b	
\bdelle\b	
\bdello\b	
\bfermo\b	fm
\bitaly\b	it
\blargo\b	l go
\blecce\b	
\blecco\b	lc
\blucca\b	lu
\bnegli\b	
\bnella\b	
\bnelle\b	
\bnello\b	
\bnorth\b	n
\bnuoro\b	nu
\bovest\b	o
\bparma\b	pr
\bpavia\b	pv
\bplace\b	l go
\bprato\b	po
\brieti\b	ri
\bsaint\b	san
\bsanta\b	san
\bsante\b	san
\bsanti\b	san
\bsanto\b	san
\bsiena\b	si
\bsouth\b	s
\bsugli\b	
\bsulla\b	
\bsulle\b	
\bsullo\b	
\bterni\b	tr
\budine\b	ud
\bviale\b	c so
\bagli\b	
\balla\b	
\balle\b	
\ballo\b	
\basti\b	at
\bbari\b	ba
\bcomo\b	co
\bdall\b	
\bdell\b	
\beast\b	e
\benna\b	
\blodi\b	
\bnell\b	
\bnord\b	n
\bp\s+le\b	l go
\bp\s+za\b	l go
\bpisa\b	pi
\bpope\b	papa
\broma\b	rm
\bs\s+da\b	road
\bsant\b	san
\bsull\b	
\bv\s+le\b	c so
\bwest\b	o
\ball\b	
\bdai\b	
\bdal\b	
\bdei\b	
\bdel\b	
\best\b	e
\bgli\b	
\bles\b	
\bnei\b	
\bnel\b	
\bsud\b	s
\bsui\b	
\bsul\b	
\bway\b	via
\bai\b	
\bal\b	
\bda\b	
\bdi\b	
\ben\b	
\bil\b	
\bin\b	
\bla\b	
\ble\b	
\blo\b	
\bsu\b	
\ba\b	
\bd\b	
\bi\b	
\bl\b	
\bw\b	o
