\bgrand\s+\-\s+duchesse\s+charlotte\b	g d charlotte
\bfranklin\s+delano\s+roosevelt\b	f d roosevelt
\bgrande\s+duchesse\s+charlotte\b	g d charlotte
\bgrand\s+duchesse\s+charlotte\b	g d charlotte
\bcharles\s+frederic\s+mersch\b	charles fred mersch
\berpeldange\s+\-\s+lez\s+\-\s+bous\b	erpeldange
\bjohn\s+fitzgerald\s+kennedy\b	j f k
\bfranklin\s+d\s+roosevelt\b	f d roosevelt
\bhostert\s+niederanven\b	hostert
\bg\s+\-\s+d\s+charlotte\b	g d charlotte
\bjohn\s+f\s+kennedy\b	j f k
\bgoebelsmuehle\b	goebelsmuhle
\bj\s+\-\s+f\s+kennedy\b	j f k
\bbuederscheid\b	buderscheid
\bschwebsingen\b	schwebsange
\bj\s+f\s+kennedy\b	j f k
\brammeldange\b	rameldange
\bcul\s+de\s+sac\b	cds
\bcul\-de\-sac\b	cds
\bgeyershaff\b	geyershof
\blexembourg\b	lu
\bluxembourg\b	lu
\brond\-point\b	rdpt
\bboulevard\b	bd
\bcarrefour\b	carref
\bcroissant\b	crois
\bdiversion\b	divers
\bechangeur\b	ech
\besplanade\b	esp
\bluxemburg\b	lu
\bpromenade\b	prom
\bcapellen\b	cap
\bterrasse\b	tsse
\bcircuit\b	circt
\bimpasse\b	imp
\bplateau\b	plat
\bsentier\b	sent
\bstrasse\b	str
\bavenue\b	av
\bcenter\b	c
\bcentre\b	c
\bchemin\b	ch
\bpointe\b	pte
\bruelle\b	rle
\ballee\b	all
\bcarre\b	car
\bcourt\b	crt
\bdrive\b	dr
\bouest\b	w
\bplace\b	pl
\bpoint\b	pt
\broute\b	rte
\bboul\b	bd
\bchem\b	ch
\bespl\b	esp
\bnord\b	n
\bwest\b	w
\bave\b	av
\bctr\b	c
\bdes\b	
\best\b	e
\blux\b	lu
\bost\b	e
\brue\b	r
\bsud\b	s
\bde\b	
\bdu\b	
\bd\b	
\bo\b	e
