\bwladyslawa\s+stanislawa\s+reymonta\b	reymonta
\bwladyslaw\s+stanislaw\s+reymonta\b	reymonta
\bmaria\s+salomea\s+sklodowska\b	sklodowskiej
\bmarii\s+curie\s+sklodowskiej\b	sklodowskiej
\bmarii\s+sklodowskiej\s+curie\b	sklodowskiej
\bstefana\s+grota\s+roweckiego\b	grota roweckiego
\bkarola\s+swierczewskiego\b	swierczewski
\bwladyslawa\s+sikorskiego\b	sikorskiego
\bkazimierza\s+pulaskiego\b	pulaskiego
\bhenryka\s+sienkiewicza\b	sienkiewicza
\bjuliusza\s+slowackiego\b	slowackiego
\bleopolda\s+okulickiego\b	okulickiego
\bstefana\s+wyszynskiego\b	wyszynskiego
\bjana\s+kochanowskiego\b	jan kochanowskiego
\bjozefa\s+pilsudskiego\b	pilsudskiego
\bkuyavian\s+pomeranian\b	kp
\bnicolaus\s+copernicus\b	mikolaja kopernika
\bstefana\s+zeromskiego\b	zeromski
\btadeusza\s+kosciuszki\b	kosciuszki
\bwladyslawa\s+reymonta\b	reymonta
\bcurie\s+sklodowskiej\b	sklodowskiej
\bkarol\s+swierczewski\b	swierczewski
\bkarol\s+swierczweksi\b	swierczewski
\bmarii\s+konopnickiej\b	maria konopnicka
\bsklodowskiej\s+curie\b	sklodowskiej
\bstefan\s+zeromskiego\b	zeromski
\bwladyslawa\s+andersa\b	andersa
\bzachodniopomorskie\b	zp
\badama\s+mickiewicza\b	mickiewicza
\bfryderyka\s+chopina\b	chopin
\bwincentego\s+witosa\b	witosa
\bfrederic\s+chopina\b	chopin
\bjana\s+kilinskiego\b	kilinskiego
\bwarmian\s+masurian\b	wn
\bblogoslawionego\b	bl
\bboleslawa\s+prusa\b	boleslaw prus
\bswierczewskiego\b	swierczewski
\bwest\s+pomeranian\b	zp
\bblogoslawionej\b	bl
\bgreater\s+poland\b	wp
\bh\s+sienkiewicza\b	sienkiewicza
\bjozefa\s+hallera\b	hallera
\blower\s+silesian\b	ds
\bswietokrzyskie\b	sk
\bj\s+slowackiego\b	slowackiego
\blesser\s+poland\b	mp
\bpodporucznika\b	ppor
\bpodpulkownika\b	pplk
\bsubcarpathian\b	pk
\bwielkopolskie\b	wp
\bdolnoslaskie\b	ds
\bpodkarpackie\b	pk
\bpodporucznik\b	ppor
\bt\s+kosciuszki\b	kosciuszki
\bjozefa\s+bema\b	bema
\bmalopolskie\b	mp
\bmazowieckie\b	ma
\bpporucznika\b	ppor
\bppulkownika\b	pplk
\bpomeranian\b	pm
\bporucznika\b	por
\bpporucznik\b	ppor
\bppulkownik\b	pplk
\bpulkownika\b	plk
\bkardynala\b	kard
\blubelskie\b	lu
\bmarszalka\b	marsz
\bpodlaskie\b	pd
\bpomorskie\b	pm
\bporucznik\b	por
\bprofesora\b	prof
\bwarminsko\b	wn
\bgenerala\b	gen
\bkapitana\b	kpt
\bkujawsko\b	kp
\blubuskie\b	lb
\bmasovian\b	ma
\bopolskie\b	op
\bpoludnie\b	south
\bprofesor\b	prof
\bsilesian\b	sl
\bswietego\b	sw
\bwschodni\b	east
\bzachodni\b	west
\bbiskupa\b	bp
\bdoktora\b	dr
\bksiedza\b	ks
\blodzkie\b	ld
\bosiedle\b	os
\bprymasa\b	prym
\bsilesia\b	sl
\bslaskie\b	sl
\bswietej\b	sw
\bbiskup\b	bp
\bdoktor\b	dr
\blublin\b	lu
\blubusz\b	lb
\bmajora\b	mjr
\bpoland\b	pl
\bpolnoc\b	north
\bwschod\b	east
\bzachod\b	west
\bopole\b	op
\bpplka\b	pplk
\blodz\b	ld
\bmjra\b	mjr
\bplka\b	plk
\bwlkp\b	wp
\bbpa\b	bp
