\bartur\s+de\s+sacadura\s+freire\s+cabral\b	sacadura cabral
\bmanuel\s+maria\s+barbosa\s+du\s+bocage\b	barbosa du bocage
\bjose\s+maria\s+de\s+eca\s+de\s+queiros\b	eca de queiros
\bhumberto\s+da\s+silva\s+delgado\b	humberto delgado
\bdom\s+nuno\s+alvares\s+pereira\b	nuno alvares pereira
\bmovimento\s+forcas\s+armadas\b	mfa
\bmiguel\s+auguato\s+bombarda\b	miguel bombarda
\bcamilo\s+castelo\s+branco\b	castelo branco
\bfrancisco\s+sa\s+carneiro\b	sa carneiro
\bestrada\s+municipal\b	m
\bestrada\s+nacional\b	n
\beca\s+de\s+queiroz\b	eca de queiros
\bentrocamento\b	cruzamento
\bjulio\s+diniz\b	julio dinis
\bcomandante\b	commander
\bengenheiro\b	engineer
\bocidente\b	w
\bportugal\b	pt
\bcaptain\b	capitao
\bgeneral\b	gen
\boriente\b	
\brotunda\b	rot
\barcada\b	arc.
\bdesvio\b	desv.
\bdoctor\b	dr
\bdoutor\b	dr
\bleste\b	
\bm\s+f\s+a\b	mfa
\bnorte\b	n
\bnorth\b	n
\boeste\b	w
\bsouth\b	s
\beast\b	
\beste\b	
\brota\b	r.
\bwest\b	w
\bdas\b	
\bdos\b	
\brt\.\b	rot
\brta\b	rot
\bsao\b	s
\bsul\b	s
\bda\b	
\bde\b	
\bdo\b	
\bem\b	m
\ben\b	n
\be\b	
