\bconstantin\s+dobrogeanu\s+gherea\b	constantin gherea
\bmartin\s+luthermartin\s+luther\b	luther
\bvasile\s+bogdanvasile\s+bogdan\b	vasile bogdan
\bstefan\s+cel\s+mare\s+si\s+sfant\b	stephen iii
\bhenri\s+mathias\s+berthelot\b	h m berthelot
\bion\s+constantin\s+bratianu\b	i c
\balexandru\s+ioan\s+cuza\b	a i cuza
\bgrigore\s+otetelisanu\b	grigore otetel
\bmartin\s+luthermartin\b	luther
\bion\s+luca\s+caragiale\b	i l caragiale
\bdimitrie\s+cantemir\b	dimitre cantemir
\bdobrogeanu\s+gherea\b	constantin gherea
\bgavriil\s+musicescu\b	gavril musicescu
\bion\s+voda\s+viteazul\b	ion voda viteazu
\bstefan\s+al\s+iii\s+lea\b	stephen iii
\bandrei\s+muresanu\b	andrei muresan
\bpintea\s+viteazul\b	pintea viteazu
\bsimion\s+barnutiu\b	barnutiu
\bstefan\s+cel\s+mare\b	stephen iii
\bion\s+constantin\b	i c
\bmihai\s+viteazul\b	mihai viteazu
\btell\s+christian\b	christiantell
\bion\s+dragalina\b	dragalina
\bmartin\s+luther\b	luther
\bsandor\s+petofi\b	petofi sandor
\bagricultorii\b	agricultori
\bdimitrie\s+iov\b	dumitru iov
\bdorobantilor\b	dorobanti
\bdrumu\s+expres\b	highway
\belena\s+doamna\b	doamna elena
\bdrum\s+expres\b	highway
\bsamuil\s+micu\b	samuel micu
\bautostrada\b	highway
\bexpressway\b	highway
\bmarshall\b	maresal
\bmotorway\b	sosea
\barmatei\b	armata
\bgeneral\b	gen
\bromania\b	ro
\bsoseaua\b	sosea
\bavenue\b	cale
\bdoctor\b	dr
\bdrumul\b	drum
\bromane\b	romana
\bstrada\b	str
\bstreet\b	str
\baleea\b	alee
\bcalea\b	cale
\bhoria\b	horea
\bion\s+c\b	i c
\bnorth\b	nord
\bsouth\b	sud
\beast\b	est
\broad\b	str
\bwest\b	vest
