\bprince\s+muqrin\s+bin\s+abdulaziz\s+al\s+saud\b	الأمير مقرن بن عبد الع
\babdul\s+majeed\s+bin\s+abdulaziz\s+al\s+saud\b	الامير عبد المجيد بن عبد العزي
\bطريق\s+الأمير\s+عبدالمجيد\s+بن\s+عبدالعزيز\b	الامير عبد المجيد بن عبد العزي
\bking\s+faisal\s+bin\s+abdulaziz\s+al\s+saud\b	طريق الملك فيصل
\bالأمير\s+مقرن\s+بن\s+عبد\s+العزيز\s+آل\s+سعود\b	الأمير مقرن بن عبد الع
\bking\s+fahd\s+bin\s+abdulaziz\s+al\s+saud\b	الملك فهد
\bmuhammad\s+ibn\s+musa\s+al\s+khwarizmi\b	الخوارزمي
\bkhalid\s+bin\s+abdulaziz\s+al\s+saud\b	الملك خالد
\bsultan\s+bin\s+abdulaziz\s+al\s+saud\b	سلطان بن عبد العزيز
\btalal\s+bin\s+abdul\s+aziz\s+al\s+saud\b	الأمير طلال
\bشارع\s+الملك\s+فيصل\s+بن\s+عبدالعزيز\b	طريق الملك فيصل
\bعبدالله\s+بن\s+عبدالعزيز\s+آل\s+سعود\b	الملك عبدالله
\babdul\s+muhsen\s+bin\s+abdul\s+aziz\b	عبدالعزيز
\bking\s+abdullah\s+bin\s+abdulaziz\b	الملك عبدالله
\bسلطان\s+بن\s+عبد\s+العزيز\s+آل\s+سعود\b	سلطان بن عبد العزيز
\bالأمير\s+سلطان\s+بن\s+عبد\s+العزيز\b	سلطان بن عبد العزيز
\bالامير\s+سلطان\s+بن\s+عبد\s+العزيز\b	سلطان بن عبد العزيز
\bالملك\s+عبدالله\s+بن\s+عبدالعزيز\b	الملك عبدالله
\bخالد\s+بن\s+عبد\s+العزيز\s+آل\s+سعود\b	الملك خالد
\bطلال\s+بن\s+عبد\s+العزيز\s+آل\s+سعود\b	الأمير طلال
\bالأمير\s+طلال\s+بن\s+عبد\s+العزيز\b	الأمير طلال
\bالامير\s+مقرن\s+بن\s+عبد\s+العزيز\b	الأمير مقرن بن عبد الع
\bفهد\s+بن\s+عبد\s+العزيز\s+آل\s+سعود\b	الملك فهد
\bفيصل\s+بن\s+عبدالعزيز\s+آل\s+سعود\b	طريق الملك فيصل
\bالاميرسلطان\s+بن\s+عبدالعزيز\b	سلطان بن عبد العزيز
\bطريق\s+الامير\s+عبدالمحسن\s+بن\b	عبدالعزيز
\bالملك\s+خالد\s+بن\s+عبدالعزيز\b	الملك خالد
\bعبدالمحسن\s+بن\s+عبدالعزيز،\b	عبدالعزيز
\bالملك\s+فهد\s+بن\s+عبدالعزيز\b	الملك فهد
\bالملك\s+خالد\s+بن\s+الوليد\b	خالد بن الوليد
\bمحمد\s+بن\s+موسى\s+خوارزمی\b	الخوارزمي
\bkhalid\s+ibn\s+al\s+walid\b	خالد بن الوليد
\buthman\s+ibn\s+affan\b	عثمان
\bع\s+خالد\s+بن\s+الوليد\b	خالد بن الوليد
\bطريق\s+الملك\s+خالد\b	الملك خالد
\bعثمان\s+بن\s+عفان\b	عثمان
\bاثنان\s+وعشرون\b	22
\bواحد\s+وعشرون\b	21
\bثمانية\s+عشر\b	18
\bأربعة\s+عشر\b	14
\bثلاثة\s+عشر\b	13
\bاثنا\s+عشر\b	12
\bتسعة\s+عشر\b	19
\bخمسة\s+عشر\b	15
\bسبعة\s+عشر\b	17
\bأحد\s+عشر\b	11
\bستة\s+عشر\b	16
\bnumber\b	رقم
\bprince\b	أمير
\bstreet\b	شارع
\bأربعون\b	40
\bالامير\b	أمير
\bالطريق\b	road
\bثامنية\b	8
\bثلاثون\b	30
\bثمانون\b	80
\bnorth\b	n
\bsouth\b	s
\bأربعة\b	4
\bإثنان\b	2
\bالملك\b	ملك
\bتسعون\b	90
\bثلاثة\b	3
\bخمسون\b	50
\bسبعون\b	70
\bعشرون\b	20
\bوا\s+حد\b	1
\beast\b	e
\bking\b	ملك
\bwest\b	w
\bتعسة\b	9
\bخمسة\b	5
\bسبعة\b	7
\bستون\b	60
\bستّة\b	6
\bطريق\b	road
\bعشرة\b	10
\bمائة\b	100
\bصفر\b	0
\bمئة\b	100
