\bboulevard\b	blvd
\bextension\b	ext
\bcircular\b	cir
\bcrescent\b	cr
\bhigh\s+way\b	highway
\bavenue\b	av
\bnumber\b	#
\bstreet\b	st
\bdrive\b	dr
\bnorth\b	n
\bsouth\b	s
\btrace\b	tr
\beast\b	e
\bext\.\b	ext
\blane\b	ln
\broad\b	rd
\bwest\b	w
\bave\b	av
\bno\.\b	#
\brd\.\b	rd
\bst\.\b	st
\btr\.\b	tr
\bno\b	#
