\brepublic\s+of\s+south\s+africa\b	sa
\bbhambatha\s+kamancinza\b	bambatha
\bkwazulu\s+natal\b	nl
\bnorthern\s+cape\b	nc
\beastern\s+cape\b	ec
\bkwazulunatal\b	nl
\bsouth\s+africa\b	sa
\bwestern\s+cape\b	wc
\bfree\s+state\b	fs
\bmpumalanga\b	mp
\bnoord\s+kaap\b	nc
\bnorth\s+west\b	nw
\bbhambatha\b	bambatha
\bboulevard\b	blvd
\bfreestate\b	fs
\bcrescent\b	sgl
\bnoordwes\b	nw
\boos\s+kaap\b	ec
\bvrystaat\b	fs
\bwes\s+kaap\b	wc
\bgauteng\b	gp
\bhighway\b	hwy
\blimpopo\b	lp
\buithoek\b	nook
\bavenue\b	ln
\bchurch\b	kerk
\bnoorde\b	n
\brylaan\b	dr
\bschool\b	skool
\bsingel\b	sgl
\bsirkel\b	circle
\bsquare\b	sq
\bstraat\b	st
\bstreet\b	st
\balley\b	aly
\bdraai\b	turn
\bdrive\b	dr
\bkring\b	loop
\bnatal\b	nl
\bnoord\b	n
\bnorth\b	n
\booste\b	o
\bplace\b	oord
\bplein\b	sq
\broads\b	rd
\bsaint\b	st
\bsouth\b	s
\bsteeg\b	aly
\bsuide\b	s
\bweste\b	w
\bcres\b	sgl
\beast\b	o
\blaan\b	ln
\bpath\b	pad
\broad\b	rd
\bsuid\b	s
\bwest\b	w
\bave\b	ln
\bkzn\b	nl
\boos\b	o
\bway\b	rd
\bweg\b	rd
\bwes\b	w
\bgt\b	gp
\bza\b	sa
\bzn\b	nl
